8 8 *

...##...
.#...T..
.####...
....####
###..#M#
...#....
..T####.
........
