8 8

  13624234
1 ....#...
4 .##.#.#.
3 ..#.#.#.
2 #.#.....
4 ..##.#.#
5 .###.#.#
3 .##....#
3 ....#M##
