10 10 *

##......##
.X.####.X.
.#...##.#.
.#T..#b.#.
.#...#.##.
.####..##.
...b#.#M..
###...###.
#M#####.X.
#.......##
