8 8 *

###M###M
M#...#..
...#...#
#.###.##
...#...#
M#M#...#
####..T#
########
