8 8 *

#...###M
..#..#..
.###...#
.M#..#..
###.###.
##...#..
##.T.#.#
##...#.M
