8 8

  72613261
0 M.......
7 #######.
3 #M#T..#.
3 #.#...#.
3 #.#...#.
5 #.#.###.
2 #...#...
5 ###...##
